# lvlwidth 21
# lvlheight 23
# bgcolor 0 0 0
# edgelightcolor 255 255 255
# edgeshadowcolor 100 100 100
# fillcolor 175 175 175
# pelletcolor 255 255 255
# fruittype 0

# startleveldata
0 0 0 0 0 0 0 0 0 0 0 0 0 0 0 0 0 0 0 0 0 
0 0 107 100 100 100 100 100 100 100 100 100 100 100 100 100 100 100 108 0 0 
0 0 101 0 0 0 10 0 0 0 0 0 0 0 0 0 0 0 101 0 0 
0 0 101 0 107 112 1 111 108 0 0 0 0 0 0 0 0 0 101 0 0 
0 0 101 0 101 11 12 13 101 0 0 0 0 0 0 0 0 0 101 0 0 
0 0 101 0 105 100 100 100 106 0 111 100 100 100 100 100 100 100 132 0 0 
0 0 101 0 0 0 0 0 0 0 0 0 0 0 0 0 0 0 101 0 0 
0 0 131 100 100 100 100 100 100 100 100 100 100 100 100 100 112 0 101 0 0 
0 0 101 0 0 0 0 0 2 2 2 2 2 2 0 0 0 0 101 0 0 
0 0 101 0 0 0 0 0 0 4 0 0 0 0 0 0 0 0 101 0 0 
0 0 101 0 0 0 0 0 0 0 0 0 0 0 0 0 0 0 101 0 0 
0 0 101 0 0 0 0 0 0 0 3 0 0 0 0 0 0 0 101 0 0 
0 0 105 100 100 100 100 100 100 100 100 100 100 100 100 100 100 100 106 0 0 
0 0 0 0 0 0 0 0 0 0 0 0 0 0 0 0 0 0 0 0 0 
0 0 0 0 0 0 0 0 0 0 0 0 0 0 0 0 0 0 0 0 0 
0 0 0 0 0 0 0 0 0 0 0 0 0 0 0 0 0 0 0 0 0 
0 0 0 0 0 0 0 0 0 0 0 0 0 0 0 0 0 0 0 0 0 
0 0 0 0 0 0 0 0 0 0 0 0 0 0 0 0 0 0 0 0 0 
0 0 0 0 0 0 0 0 0 0 0 0 0 0 0 0 0 0 0 0 0 
0 0 0 0 0 0 0 0 0 0 0 0 0 0 0 0 0 0 0 0 0 
0 0 0 0 0 0 0 0 0 0 0 0 0 0 0 0 0 0 0 0 0 
0 0 0 0 0 0 0 0 0 0 0 0 0 0 0 0 0 0 0 0 0 
0 0 0 0 0 0 0 0 0 0 0 0 0 0 0 0 0 0 0 0 0 
# endleveldata

# sprites
